#                         #
#                         #
#                         #
#                         #
#   #                     #
#                         #
#                         #
#             ####        #
#      S   ####           #
#    ####                 #
#                         #
#                      #  #
#                      #  #
#                      #  #
#                      #  #
#                      #  #
########### ## #####  #####

